1111111111111
1P11000000001
100C011111101
10001110001E1
1111111111111