11111111111111111111
1P000000000000000001
10001111110111110001
100C0000000000000001
11111011110111111101
100000000C0000010001
10111111111110101111
10000000000000C00001
10111011111011111111
1C000000000000000EC1
11111111111111111111