11111111111111111111111111111111111111111111111111111111111
1P000000000000000001111111111111111111111111111111111111111
10001111110111110001111111111111111111111111111111111111111
100C0000000000000001111111111111111111111111111111111111111
11111011110111111101111111111111111111111111111111111111111
100000000C0000010001111111111111111111111111111111111111111
10111111111110101111111111111111111111111111111111111111111
10000000000000C00001111111111111111111111111111111111111111
10111011111011111111111111111111111111111111111111111111111
1C0000000000000000E1111111111111111111111111111111111111111
11111111111111111111111111111111111111111111111111111111111