1111111111111111111111111111
1P00000100000000000000000001
1000111111111011111011111001
100000000C000000000000000001
1011111011101110111011111111
10000000100000100000000C0001
1110111111111011111111111111
1C00000000000000000000000E11
1111111111111111111111111111