111111111111111111111111111111111111111111111111111111111111111111111111111111111111111111111111111111111
10E011111111111111111111111111111111111111111111111111111111111111111111111111111111111111111111111111111
11C011111111111111111111111111111111111111111111111111111111111111111111111111111111111111111111111111111
111P11111111111111111111111111111111111111111111111111111111111111111111111111111111111111111111111111111
111111111111111111111111111111111111111111111111111111111111111111111111111111111111111111111111111111111