11111
10E01
11C01
111P1
11111
