11111111111111
100100000000C1
10000111110001
1P0011EC000001
11111111111111