1111111111111111111111
1P00000000000000000111
1000111111011111000111
100C000000000000000111
1111101111011111110111
100000000C000001000111
1011111111111010111111
10000000000000C0000111
1011101111101111111111
1C0000000000000000E111
1111111111111111111111
